# 100 0	# 100 0	# 100 0	# 100 0	# 100 0	# 100 0	# 100 0	# 100 0	# 100 0	# 100 0	# 100 0	# 100 0	# 100 0	# 100 0	# 100 0	# 100 0	# 100 0
# 100 0	. 100 0	D 100 0	. 100 0	. 100 0	. 100 0	. 100 0	. 100 0	. 100 0	. 100 0	. 100 0	# 100 0	. 100 0	. 100 0	. 100 0	. 100 0	# 100 0
# 100 0	. 100 0	# 100 0	. 100 0	. 100 0	. 100 0	. 100 0	. 100 0	. 100 0	. 100 0	. 100 0	# 100 0	# 100 0	# 100 0	. 100 0	. 100 0	# 100 0
# 100 0	. 100 0	# 100 0	. 100 0	. 100 0	. 100 0	. 100 0	. 100 0	. 100 0	. 100 0	. 100 0	. 100 0	. 100 0	# 100 0	. 100 0	. 100 0	# 100 0
# 100 0	. 100 0	# 100 0	. 100 0	. 100 0	. 100 0	. 100 0	. 100 0	. 100 0	. 100 0	. 100 0	. 100 0	. 100 0	. 100 0	. 100 0	. 100 0	# 100 0
# 100 0	. 100 0	# 100 0	D 100 0	. 100 0	. 100 0	. 100 0	. 100 0	. 100 0	. 100 0	. 100 0	. 100 0	. 100 0	. 100 0	. 100 0	. 100 0	# 100 0
# 100 0	. 100 0	. 100 0	. 100 0	D 100 0	. 100 0	. 100 0	. 100 0	. 100 0	. 100 0	. 100 0	. 100 0	. 100 0	. 100 0	. 100 0	. 100 0	# 100 0
# 100 0	. 100 0	. 100 0	. 100 0	. 100 0	. 100 0	. 100 0	. 100 0	# 100 0	# 100 0	# 100 0	# 100 0	. 100 0	. 100 0	. 100 0	. 100 0	# 100 0
# 100 0	. 100 0	. 100 0	. 100 0	. 100 0	. 100 0	. 100 0	. 100 0	. 100 0	. 100 0	. 100 0	. 100 0	. 100 0	. 100 0	. 100 0	. 100 0	# 100 0
# 100 0	. 100 0	D 100 0	. 100 0	. 100 0	. 100 0	. 100 0	. 100 0	. 100 0	. 100 0	. 100 0	. 100 0	. 100 0	# 100 0	# 100 0	# 100 0	# 100 0
# 100 0	. 100 0	. 100 0	. 100 0	. 100 0	. 100 0	. 100 0	. 100 0	. 100 0	. 100 0	. 100 0	. 100 0	. 100 0	. 100 0	. 100 0	. 100 0	# 100 0
# 100 0	. 100 0	. 100 0	. 100 0	. 100 0	. 100 0	# 100 0	. 100 0	. 100 0	. 100 0	. 100 0	. 100 0	. 100 0	# 100 0	# 100 0	# 100 0	# 100 0
# 100 0	. 100 0	. 100 0	. 100 0	. 100 0	. 100 0	. 100 0	. 100 0	. 100 0	. 100 0	. 100 0	. 100 0	. 100 0	. 100 0	. 100 0	. 100 0	# 100 0
# 100 0	. 100 0	. 100 0	. 100 0	. 100 0	. 100 0	. 100 0	. 100 0	. 100 0	. 100 0	. 100 0	. 100 0	. 100 0	. 100 0	. 100 0	. 100 0	# 100 0
# 100 0	# 100 0	# 100 0	# 100 0	# 100 0	# 100 0	# 100 0	# 100 0	# 100 0	# 100 0	# 100 0	# 100 0	# 100 0	# 100 0	# 100 0	# 100 0	# 100 0