# 3 0	# 3 0	# 3 0	# 3 0	# 3 0	# 3 0	# 3 0	# 3 0	# 3 0	# 3 0	# 3 0	# 3 0	# 3 0	# 3 0	# 3 0	# 3 0	# 3 0
# 3 0	D 3 0	. 3 0	D 3 0	. 3 0	. 3 0	. 3 0	. 3 0	. 3 0	. 3 0	. 3 0	# 3 0	. 3 0	. 3 0	. 3 0	. 3 0	# 3 0
# 3 0	. 3 0	D 3 0	D 3 0	D 3 0	. 3 0	. 3 0	. 3 0	. 3 0	. 3 0	. 3 0	# 3 0	# 3 0	# 3 0	. 3 0	. 3 0	# 3 0
# 3 0	. 3 0	D 3 0	D 3 0	D 3 0	. 3 0	. 3 0	. 3 0	. 3 0	. 3 0	. 3 0	. 3 0	. 3 0	# 3 0	. 3 0	. 3 0	# 3 0
# 3 0	. 3 0	. 3 0	. 3 0	. 3 0	D 3 0	. 3 0	. 3 0	. 3 0	. 3 0	. 3 0	. 3 0	. 3 0	. 3 0	. 3 0	. 3 0	# 3 0
# 3 0	. 3 0	. 3 0	D 3 0	. 3 0	D 3 0	. 3 0	. 3 0	. 3 0	. 3 0	. 3 0	. 3 0	. 3 0	. 3 0	. 3 0	. 3 0	# 3 0
# 3 0	. 3 0	. 3 0	. 3 0	D 3 0	. 3 0	. 3 0	. 3 0	. 3 0	. 3 0	. 3 0	. 3 0	. 3 0	. 3 0	. 3 0	. 3 0	# 3 0
# 3 0	. 3 0	. 3 0	. 3 0	. 3 0	. 3 0	. 3 0	. 3 0	# 3 0	# 3 0	# 3 0	# 3 0	. 3 0	. 3 0	. 3 0	. 3 0	# 3 0
# 3 0	. 3 0	. 3 0	. 3 0	. 3 0	. 3 0	. 3 0	. 3 0	. 3 0	. 3 0	. 3 0	. 3 0	. 3 0	. 3 0	. 3 0	. 3 0	# 3 0
# 3 0	. 3 0	D 3 0	. 3 0	. 3 0	. 3 0	. 3 0	. 3 0	. 3 0	. 3 0	. 3 0	. 3 0	. 3 0	# 3 0	# 3 0	# 3 0	# 3 0
# 3 0	. 3 0	. 3 0	. 3 0	. 3 0	. 3 0	. 3 0	. 3 0	. 3 0	. 3 0	. 3 0	. 3 0	. 3 0	. 3 0	. 3 0	. 3 0	# 3 0
# 3 0	. 3 0	. 3 0	. 3 0	. 3 0	. 3 0	# 3 0	. 3 0	. 3 0	. 3 0	. 3 0	. 3 0	. 3 0	# 3 0	# 3 0	# 3 0	# 3 0
# 3 0	. 3 0	. 3 0	. 3 0	. 3 0	. 3 0	. 3 0	. 3 0	. 3 0	. 3 0	. 3 0	. 3 0	. 3 0	. 3 0	. 3 0	. 3 0	# 3 0
# 3 0	. 3 0	. 3 0	. 3 0	. 3 0	. 3 0	. 3 0	. 3 0	. 3 0	. 3 0	. 3 0	. 3 0	. 3 0	. 3 0	. 3 0	. 3 0	# 3 0
# 3 0	# 3 0	# 3 0	# 3 0	# 3 0	# 3 0	# 3 0	# 3 0	# 3 0	# 3 0	# 3 0	# 3 0	# 3 0	# 3 0	# 3 0	# 3 0	# 3 0